11111111111111
1E00000C000001
10100101001001
10000100101011
10P000000C00C1
11111111111111
